XXXXXXXXXXXXXXXXXXXXX
X    S              X
X XXXXXXXXHXXXXXXXX X
X         H   T     X
XHXXXXXXXXXXXXXXXXXHX
XH                 HX
XH                 HX
XH                 HX
XH                 HX
XH T      T      T HX
XHXXXXXXXXXXXXXXXXXHX
XH                 HX
XH                 HX
XH                 HX
XH                 HX
XH                 HX
XXXXXXXXXXHXXXXXXXXXX
X         H         X
XXXXXXXXXXXXXXXXXXXHX
XK                 HX
XXXXXXXXXXXXXXXXXXXXX
