XXXXXXXXXXXXXXXXXXXXX
X                   X
X                   X
X                   X
X  S                X
XXXXXXXH     HXXXXXXX
X      H     H      X
X      H     H      X
X      H     H      X
X      H  T  H      X
X   HXXXXXXXXXXXH   X
X   H           H   X
X   H           H   X
X   H           H   X
XT  H           H  TX
XXXXXXXH     HXXXXXXX
X      H     H      X
X      H     H      X
X      H     H      X
X      H  K  H      X
XXXXXXXXXXXXXXXXXXXXX
